SO ./assets/bark.xpm
WE ./assets/bookshelf.xpm
EA ./assets/bricks.xpm
NO ./assets/leavesop.xpm
DO ./assets/door.xpm

C 135,206,235
F 131,101,57

11111
10S00
11111