SO ./sprites/rgb.xpm
WE ./sprites/Normal-Select.xpm
EA ./sprites/Normal-Select.xpm
NO ./sprites/Wall48.xpm

C 135,206,235
F 131,101,57

111111111
100010001
10N011011
100010001
110110001
100000001
100010111
100010001
111111111