SO ./sprites/Achyue1.xpm
WE ./sprites/Lena.xpm
EA ./sprites/weekender-girl-heart/5dd20da7e68e4244cf3a61fce2fb3bf1mn3f8G6y2RK7YBqR-20.xpm
NO ./sprites/vocallective-_1.xpm

C 135,206,235
F 131,101,57

111111111111111
100000010000001
100000010000001
100011111100111
100000010000001
100000010000001
100000010000001
110011110000001
100000000000001
100000000000001
1000N0010011111
100000010000001
100000010000001
100000010000001
111111111111111