SO ./sprites/diversity_cover.xpm
WE ./sprites/Lena.xpm
EA ./sprites/weekender-girl-heart/5dd20da7e68e4244cf3a61fce2fb3bf1mn3f8G6y2RK7YBqR-20.xpm
NO ./sprites/vocallective-_1.xpm

C 135,206,235
F 83,175,80

111111111
100000001
101000101
100000001
100010001
100000001
1000S0001
100000001
100000001
100000001
100000001
100000101
100000001
101000101
100010001
100000001
100000101
110001001
101000001
100100001
100010001
111111111