SO ./sprites/diversity_cover.xpm
WE ./sprites/Lena.xpm
EA ./sprites/pathos_cover.xpm
NO ./sprites/vocallective-_1.xpm

C 135,206,235
F 83,175,80

 111111111  111111111  111111111  111111111 
10202020201102020202011020202020110202020201
12121212121121212121211212121212112121212121
10202020201102020202011020202020110202020201
12121212121121212121211212121212112121212121
10202020201102020202011020202020110202020201
12121212121121212121211212121212112121212121
10202020201102020202011020202020110202020201
12121212121121212121211212121212112121212121
 111111111  111111111  111111111  111111111 
 111111111  111111111  111111111  111111111 
10202020201102020202011020202020110202020201
12121212121121212121211212121212112121212121
10202020201102020202011020202020110202020201
12121212121121212121211212121212112121212121
1020202020110202N202011020202020110202020201
12121212121121212121211212121212112121212121
10202020201102020202011020202020110202020201
12121212121121212121211212121212112121212121
 111111111  111111111  111111111  111111111 
 111111111  111111111  111111111  111111111 
10202020201102020202011020202020110202020201
12121212121121212121211212121212112121212121
10202020201102020202011020202020110202020201
12121212121121212121211212121212112121212121
10202020201102020202011020202020110202020201
12121212121121212121211212121212112121212121
10202020201102020202011020202020110202020201
12121212121121212121211212121212112121212121
 111111111  111111111  111111111  111111111 
 111111111  111111111  111111111  111111111 
10202020201102020202011020202020110202020201
12121212121121212121211212121212112121212121
10202020201102020202011020202020110202020201
12121212121121212121211212121212112121212121
10202020201102020202011020202020110202020201
12121212121121212121211212121212112121212121
10202020201102020202011020202020110202020201
12121212121121212121211212121212112121212121
 111111111  111111111  111111111  111111111 
 111111111  111111111  111111111  111111111 
10202020201102020202011020202020110202020201
12121212121121212121211212121212112121212121
10202020201102020202011020202020110202020201
12121212121121212121211212121212112121212121
10202020201102020202011020202020110202020201
12121212121121212121211212121212112121212121
10202020201102020202011020202020110202020201
12121212121121212121211212121212112121212121
 111111111  111111111  111111111  111111111 
 111111111  111111111  111111111  111111111 
10202020201102020202011020202020110202020201
12121212121121212121211212121212112121212121
10202020201102020202011020202020110202020201
12121212121121212121211212121212112121212121
10202020201102020202011020202020110202020201
12121212121121212121211212121212112121212121
10202020201102020202011020202020110202020201
12121212121121212121211212121212112121212121
 111111111  111111111  111111111  111111111 
 111111111  111111111  111111111  111111111 
10202020201102020202011020202020110202020201
12121212121121212121211212121212112121212121
10202020201102020202011020202020110202020201
12121212121121212121211212121212112121212121
10202020201102020202011020202020110202020201
12121212121121212121211212121212112121212121
10202020201102020202011020202020110202020201
12121212121121212121211212121212112121212121
 111111111  111111111  111111111  111111111 
 111111111  111111111  111111111  111111111 
10202020201102020202011020202020110202020201
12121212121121212121211212121212112121212121
10202020201102020202011020202020110202020201
12121212121121212121211212121212112121212121
10202020201102020202011020202020110202020201
12121212121121212121211212121212112121212121
10202020201102020202011020202020110202020201
12121212121121212121211212121212112121212121
 111111111  111111111  111111111  111111111 
 111111111  111111111  111111111  111111111 
10202020201102020202011020202020110202020201
12121212121121212121211212121212112121212121
10202020201102020202011020202020110202020201
12121212121121212121211212121212112121212121
10202020201102020202011020202020110202020201
12121212121121212121211212121212112121212121
10202020201102020202011020202020110202020201
12121212121121212121211212121212112121212121
 111111111  111111111  111111111  111111111 
 111111111  111111111  111111111  111111111 
10202020201102020202011020202020110202020201
12121212121121212121211212121212112121212121
10202020201102020202011020202020110202020201
12121212121121212121211212121212112121212121
10202020201102020202011020202020110202020201
12121212121121212121211212121212112121212121
10202020201102020202011020202020110202020201
12121212121121212121211212121212112121212121
 111111111  111111111  111111111  111111111 
 111111111  111111111  111111111  111111111 
10202020201102020202011020202020110202020201
12121212121121212121211212121212112121212121
10202020201102020202011020202020110202020201
12121212121121212121211212121212112121212121
10202020201102020202011020202020110202020201
12121212121121212121211212121212112121212121
10202020201102020202011020202020110202020201
12121212121121212121211212121212112121212121
 111111111  111111111  111111111  111111111 
 111111111  111111111  111111111  111111111 
10202020201102020202011020202020110202020201
12121212121121212121211212121212112121212121
10202020201102020202011020202020110202020201
12121212121121212121211212121212112121212121
10202020201102020202011020202020110202020201
12121212121121212121211212121212112121212121
10202020201102020202011020202020110202020201
12121212121121212121211212121212112121212121
 111111111  111111111  111111111  111111111 
