SO ./sprites/Normal-Select.xpm
WE ./sprites/Normal-Select.xpm
EA ./sprites/Normal-Select.xpm
NO ./sprites/Normal-Select.xpm

F 131,101,57

1111111111
1010000001
1010000001
10100N0001
1000000001
1000010001
1000000001
1111111111